11111111111111111111111111
1 C1 C                  C1
1    11C11111111 111111  1
1PC 11E   C111CC      C1 1
11111111111111111111111111